
minYearInDbase = 2005

dataBaseFilePath = k:\\Docs\\Д-я БиК\\КЦ ПД\\Обща\\04 Поща\\Петър\\DBaseApp\\

databaseURL = jdbc:ucanaccess://k://Docs//Д-я БиК//КЦ ПД//Обща//04 Поща//Петър//DBaseApp//WBC_DBase.mdb
filePathArhivePersonel =  Arhive\\PERSONNEL_
filePathArhiveExternal =  Arhive\\EXTERNAL_
filePathActualExternal = Arhive\\EXTERNAL_actual.xls
filePathActualPersonel =  Arhive\\PERSONNEL_actual.xls

databaseEncriptOID = qwer1234
databaseEncript = password

filePathExternal_orig = d:\\EXTERNAL.xls
filePathPersonel_orig = d:\\PERSONNEL.xls

filePathExternal_orig1 = k:\\Docs\\Д-я БиК\\КЦ ПД\\ОБД\\0_LB\\EXTERNAL.xls
filePathPersonel_orig1 = k:\\Docs\\Д-я БиК\\КЦ ПД\\ОБД\\0_LB\\PERSONNEL.xls

filePathMonthExternal_old = d:\\month\\wbc_month.xls
filePathMonthPersonel_old = d:\\month\\wbc_month_P.xls

filePathOBD = k:\\Docs\\Д-я БиК\\КЦ ПД\\ОБД\\0_LB\\

databaseOID = jdbc:ucanaccess://D://NewOid_1.mdb


modifiIcon = ICONS/Modify.gif

insertMeasuring = Измервания
insertMeasuringTipText = Въвеждане на резултати от измерванията

autoInsertMeasuting = Авоматично нанасяне на измерванията
autoInsertMeasutingTipText = въвеждане на измерванията от репорт фаилове

personManagement = Обработка на служители
personManagementTipText  = въвеждане и промяна на информация за служители


reference = Справки
referenceTipText = извличане на справка

personReference = Справки за служители
personReferenceTipText = извличане на справка по различни показатели

kodeReference = Справки за кодове
kodeReferenceTipText = извличане на справка за заети и свободни кодове

destinationDir = DIRECTORY/
destinationIcons = ICONS/ajaxLoader.gif
klikToCopy = Клилнете за да копирате
MenuOder_TitleName = Гама Кал. Екстракт
isEmptyDozeFilds = Има празни полета за дози.
isEmptyDozeNuclideFilds = Има празни полета за дози на нуклиди.
isEmptyPostaplenieNuclideFilds = Има дози с празни или нулеви полета за постъпление от нуклиди.
noSaveRowToBase = Тези редове няма да се запишат в базата.
rowWithoutSaveToExcellFile = Има редове, които няма да се запишат в ексел файла.
notSaveMeasur = В ексел файловете не намирам:
falseData = Грешни данни
fileIsOpen = Excel файлът е отворен
notSelectFile = Не е избран excel файл
dublicateRepFileInDBase = В базата има запис на стойности от репорт файл:
notResults = Няма намерени резултати
AEC = АЕЦ Козлодуй
VO = Външни организации
cell_maximum_number_exceeded = Броя на клетките са повече от 4000
code = Кодове
measurSICH = Измервания СИЧ
orders = Заповеди
freeKodeComent = Списък на свободните кодове за последните три години
nofreeKodeComent = Няма въведена област от кодова за този отдел и зона
zaDaZatvoriteRamkata = За да затворите рамката кликнете с мишката на този ред
labelCheckForSearch = маркирайте зона и отдел за търсене на свободни кодове

imaPromeniVavFayla = Файлът   е бил изменен на 
preporachvaSe = Препоръчва се актуализацията на базата данни, защото:
